111111111111111111111111111111111111
10000000000000000000000000000000001
11000000000000000000000000010000011
11001000100000000000000000000000011
10000000000000011110000000000000011
11111111111111111110000001111111111
11110000000000000000000000000000001
10000111111111111111111111111110001
10000000000011000000000000000000001
11111111111111111111000000011111111
10000000000000000000000000000000001
10101010101010101010101010101010101
10101010101010101010101010101010101
10001000100010100010001000100010101
11111101111110100010001000100010101
11111101111110000010000000000000001
10000000001000011110000011011110111
11111000111111000000111110011110111
10001110111011100110111110011110111
10111110111011111110111110011111111
10111111111000000111111111011111111
10000000000011110000000000000000001
11111111111111111111111111111111111
